XXXXXXXXXX
X........X
X.X.X.XX.X
X.X......X
X.XXXXXX.X
X........X
X.X.XX.X.X
X.X....X.X
X.XX.XXX.X
X........X
XXXXXXXXXX